11111111111111111111111111111111111111111111
10000000000000000002200000000000000000000001
10000000000020000000000002200000000000000001
10000200000000000000000000000000000000000001
10000000000002000000000000020000002000000001
10000000000020000000000000000000000000000001
100000000000000000000N0000020000000000000001
10000000002000000000000002000000000000000001
10000000000000000000000000000000000000000001
10000000000000000200000000000000000000000001
10000200000000000000002000000000100000000001
10000000000000200000000000000000000000000001
10000000001000000002000000000000000001000001
10000000000000000000000000000000000000000001
11111111111111111111111111111111111111111111
