NO ./path_to_the_north_texture
SO ./path_to_the_south_texture
EA ./path_to_the_east_texture
WE ./path_to_the_east_texture
F 220,100,000
C 225,255,0

11111111111111111111111111111
10000000000000000000000000001
10110000011100000020000000001
10010000000000000000000000001
11111111101100000111000000001
1000000000110000011101111111
11110111111111011100000010001
11110111111111011101010010001
11000000110101011100000010001
10002000000000001100N00000001
10000000000000001101010010001
11000001110101011111011110001
11110111111101011101111010001
11111111111111111111111111111
